0,0,0,0,0,0,0,0,0
0,2,2,2,0,6,0,0,0
0,2,2,2,0,6,0,0,0
0,2,2,3,2,2,0,0,0
0,4,2,2,2,2,5,7,0
0,0,0,0,0,0,0,0,0