0,0,0,0,0,0,0,0,0,0,0,0
0,2,2,2,2,2,2,2,2,2,2,0
0,2,2,4,2,2,2,2,2,2,2,0
0,2,2,2,2,2,2,2,2,2,2,0
0,2,2,2,2,2,2,2,2,2,7,0
0,0,0,0,0,0,0,0,0,0,0,0