0,0,0,0,0,0,0,0,0
0,4,2,2,0,1,0,0,0
0,2,0,2,0,2,5,7,0
0,1,0,2,2,2,0,0,0
0,0,0,0,0,0,0,0,0