0,0,0,0,2,2,1,0,1,0
2,2,2,0,2,0,0,2,2,0
2,0,2,3,6,0,6,3,2,0
4,0,2,2,2,2,2,2,2,5
0,0,0,0,0,0,0,0,2,0